{
	"legend": [
		"bridge/stairs",
		"castle",
		"dried water",
		"cliffedge",
		"forest",
		"grass",
		"lake",
		"mountain",
		"plains",
		"sand",
		"road",
		"weeds",
		"water",
		"water fall"
	],
	"round": [
		[
			["W", "W", "W", "W", "W", "W", "W", "W", "W", "P", "P", "P", "P", "P", "P", "P", "P", "P", "P", "P"],
			["W", "W", "W", "P", "P", "P", "P", "P", "P", "P", "P", "P", "P", "P", "P", "P", "P", "P", "P", "F"],
			["W", "P", "P", "P", "P", "P", "P", "R", "R", "R", "R", "R", "R", "R", "P", "P", "F", "F", "F", "F"],
			["W", "C", "C", "C", "P", "P", "P", "R", "F", "P", "P", "P", "P", "R", "P", "P", "C", "C", "C", "F"],
			["W", "C", "C", "C", "P", "P", "P", "R", "P", "P", "P", "P", "P", "R", "P", "P", "C", "C", "C", "R"],
			["W", "P", "R", "P", "F", "P", "P", "R", "P", "P", "P", "P", "P", "R", "P", "P", "F", "R", "F", "F"],
			["W", "P", "R", "R", "F", "P", "P", "R", "P", "P", "G", "G", "P", "R", "P", "P", "P", "R", "F", "P"],
			["W", "W", "P", "R", "R", "R", "R", "R", "P", "G", "G", "G", "G", "R", "R", "R", "R", "R", "P", "P"],
			["W", "W", "W", "W", "W", "P", "P", "P", "G", "G", "M", "M", "G", "P", "P", "P", "P", "G", "G", "P"]
		],
		[
			["P", "P", "P", "P", "P", "F", "F", "M", "M", "F", "F", "M", "F", "F", "F", "F", "F", "W", "W", "W"],
			["P", "P", "P", "P", "F", "R", "R", "R", "R", "R", "R", "R", "R", "R", "F", "P", "P", "P", "W", "W"],
			["P", "F", "F", "F", "F", "R", "P", "P", "P", "P", "P", "P", "P", "R", "R", "P", "P", "P", "P", "W"],
			["P", "C", "C", "C", "F", "R", "P", "P", "P", "P", "P", "P", "P", "P", "R", "P", "F", "P", "P", "P"],
			["P", "C", "C", "C", "R", "R", "P", "P", "F", "F", "P", "P", "P", "P", "R", "P", "C", "C", "C", "P"],
			["P", "P", "R", "F", "F", "R", "P", "P", "P", "P", "P", "P", "P", "P", "R", "P", "C", "C", "C", "P"],
			["P", "P", "R", "F", "P", "R", "R", "R", "P", "P", "P", "P", "P", "G", "R", "P", "P", "R", "P", "P"],
			["R", "R", "R", "P", "P", "P", "P", "R", "R", "R", "R", "R", "R", "R", "R", "P", "P", "R", "P", "P"],
			["P", "P", "G", "G", "P", "P", "P", "F", "F", "M", "M", "F", "F", "F", "R", "R", "R", "R", "F", "P"]
		],
		[
			["P", "F", "P", "P", "P", "W", "W", "W", "W", "W"],
			["P", "C", "C", "C", "P", "P", "W", "W", "W", "W"],
			["P", "C", "C", "C", "P", "P", "G", "W", "W", "W"],
			["P", "P", "R", "P", "P", "S", "S", "G", "W", "W"],
			["P", "P", "R", "P", "P", "S", "S", "G", "W", "W"],
			["R", "R", "R", "F", "P", "S", "S", "G", "P", "P"],
			["P", "P", "R", "R", "R", "R", "F", "P", "P", "P"],
			["P", "P", "W", "W", "W", "R", "R", "F", "P", "P"],
			["P", "P", "W", "W", "W", "W", "B", "W", "W", "W"],
			["P", "P", "W", "W", "W", "W", "B", "W", "W", "W"],
			["P", "P", "W", "W", "W", "W", "B", "W", "W", "W"],
			["P", "P", "P", "W", "W", "F", "P", "F", "F", "P"],
			["P", "P", "P", "P", "P", "P", "P", "P", "P", "P"],
			["F", "P", "P", "P", "P", "P", "P", "P", "P", "F"],
			["F", "P", "P", "P", "P", "P", "C", "C", "C", "P"],
			["F", "F", "P", "P", "P", "P", "C", "C", "C", "P"],
			["M", "M", "F", "P", "P", "P", "P", "P", "P", "P"],
			["M", "M", "F", "F", "F", "P", "P", "P", "P", "P"]
		],
		[
			["F", "P", "F", "F", "P", "P", "P", "P", "P", "P", "P", "P", "P", "P", "F", "M", "M", "M", "M", "M"],
			["P", "P", "P", "P", "P", "P", "P", "F", "P", "P", "P", "P", "P", "P", "P", "F", "F", "M", "M", "F"],
			["P", "P", "P", "P", "F", "R", "R", "R", "R", "R", "R", "R", "R", "R", "P", "P", "P", "P", "P", "P"],
			["P", "C", "C", "C", "P", "P", "F", "M", "M", "F", "F", "P", "P", "R", "P", "P", "C", "C", "C", "P"],
			["P", "C", "C", "C", "P", "M", "M", "M", "M", "M", "M", "F", "P", "R", "R", "R", "C", "C", "C", "R"],
			["P", "P", "P", "P", "P", "F", "M", "M", "M", "M", "F", "P", "P", "R", "P", "P", "P", "P", "P", "P"],
			["P", "P", "P", "P", "P", "P", "F", "M", "M", "F", "P", "P", "R", "R", "F", "F", "F", "P", "P", "P"],
			["P", "F", "P", "F", "F", "R", "R", "R", "R", "R", "R", "R", "R", "F", "M", "M", "M", "F", "P", "P"],
			["F", "F", "F", "F", "F", "F", "F", "P", "P", "P", "P", "P", "F", "M", "M", "M", "M", "F", "F", "P"]
		]
	]
}